9 16
################
#IIHIIIIIIIIIIO#
#IIIIIIIHIIIIII#
#IIIIHIIIIIHIII#
#IIIIIIIIIIIIII#
#IIHIIIIIIIHIII#
#IIIIHIIIIIIIII#
#vIIIIIIIHIIIII#
################