9 16
################
#         H    #
#L    \        #
#         H    #
#   T   T H    #
#         H    #
# v       H    #
#         H    #
################