6 8
########
#      #
# #    #
#O#    #
#    #v#
########