9 16
################
#             O#
#  G           #
#              #
#      G       #
#              #
#           G  #
#v             #
################