6 8
########
#v     #
# #@@  #
#O#    #
#    # #
########