21 33
#################################
#     #   #   #   #             #
##### # # # # # # ########### # #
# #   # #   #   # #           # #
# # ### ######### # ########### #
#   #   #       # #   #     #   #
# ### ### ##### # # # ### # # ###
#     #   #   #   # # #   # #   #
####### ##### ####### # ####### #
#     # #   #         #     #   #
# ##### # # # # ########### # ###
#       # # # # #           #   #
# ####### # ### # # ####### ### #
#     #   # #   # #   #   #   # #
##### # # # # ### ### # ### ### #
#     # # #   # #   # #     #   #
# ####### ##### ### # ### ### ###
#       # #       # #   #   # # #
####### # # # ##### ### ##### # #
#         # #         #         #
#################################